######
#  . #
#  $ #
#@   #
######