#######
#  .  #
# @ $ #
#    ##
######