######
# .. #
# $$ #
#@   #
######