#######
#  .  #
#     #
#  $  #
#@    #
#######