#######
# ..  #
#     #
# $$  #
#@    #
#######