############
#          #
#     .    #
#     $    #
#          #
#          #
# .$       #
#          #
#          #
#     @    #
#          #
############