#################
#       .       #
#               #
#       @       #
############ ####
#               #
#       $       #
#               #
#################