####################
#         .  @     #
#                  #
## #################
#                  #
#                  #
################# ##
#                  #
#                  #
## #################
#                  #
#                  #
################# ##
#                  #
#                  #
## #################
#        $         #
#                  #
#                  #
####################