#######
#  .  #
#  $  #
#     #
# @   #
#######