#########
#   .   #
#       #
#   #   #
# # $ # #
##     ##
#       #
#  #@#  #
#########