#########
#  #@#  #
#       #
##     ##
# # $ # #
#   #   #
#       #
#   .   #
#########