#########
#  #    #
#   #   #
#      ##
#.  $# @#
#      ##
#   #   #
#  #    #
#########