#########
#  #    #
#   #   #
##      #
#@  $# .#
##      #
#   #   #
#  #    #
#########