#######
#  .  #
#  $  #
#     #
#  @  #
#######