      #########
  #####       #####
  #       .       #
  # ##  #.#.#  ## #
  #               #
  ###  #$#$#$#  ###
#   #           #   #
### #@ #######  # ###
#   #           #   #
  ###  #$#$#$#  ###
  #               #
  # ##  #.#.#  ## #
  #       .       #
  #####       #####
      #########