###############
#      .      #
#             #
#             #
#             #
#             #
#             #
#      $      #
#             #
#             #
#             #
#             #
#             #
#      @      #
###############