###############
#      @      #
#             #
#             #
#             #
#             #
#             #
#      $      #
#             #
#             #
#             #
#             #
#             #
#      .      #
###############