###############
#             #
#             #
#             #
#             #
#             #
#             #
#@     $     .#
#             #
#             #
#             #
#             #
#             #
#             #
###############