###############
#             #
#             #
#             #
#             #
#             #
#             #
#.     $     @#
#             #
#             #
#             #
#             #
#             #
#             #
###############