#########
#   $  .#
#       #
#   $  .#
#@      #
#   $  .#
#       #
#   $  .#
#########