#########
#.  $   #
#       #
#.  $   #
#      @#
#.  $   #
#       #
#.  $   #
#########