#########
#. . . .#
#       #
#       #
#$ $ $ $#
#       #
#       #
#   @   #
#########