#########
#   @   #
#       #
#       #
#$ $ $ $#
#       #
#       #
#. . . .#
#########