#########
#   .   #
#       #
#  ###  #
#   $   #
#       #
#       #
#   @   #
#########


