#########
#   @   #
#       #
#       #
#   $   #
#  ###  #
#       #
#   .   #
#########