#########
#       #
#       #
#    #  #
#@  $# .#
#    #  #
#       #
#       #
#########