#########
#       #
#       #
#  #    #
#. #$  @#
#  #    #
#       #
#       #
#########