#########
#       #
#       #
#       #
#@  $  .#
#       #
#       #
#       #
#########