#########
#       #
#       #
#       #
#.  $  @#
#       #
#       #
#       #
#########