#########
#.      #
#   #   #
#       #
# # $   #
#       #
#       #
#      @#
#########

