#########
#@      #
#       #
#       #
#   $ # #
#       #
#   #   #
#      .#
#########