#########
#      .#
#   #   #
#       #
#   $ # #
#       #
#       #
#@      #
#########