#########
#      @#
#       #
#       #
# # $   #
#       #
#   #   #
#.      #
#########