#########
#.      #
#       #
#       #
#   $   #
#       #
#       #
#      @#
#########


