#########
#@      #
#       #
#       #
#   $   #
#       #
#       #
#      .#
#########