#########
#      .#
#       #
#       #
#   $   #
#       #
#       #
#@      #
#########