#########
#      @#
#       #
#       #
#   $   #
#       #
#       #
#.      #
#########