#########
#   .   #
#       #
#  #### #
#   $   #
#  #### #
#       #
#   @   #
#########

