#########
#   @   #
#       #
#  #### #
#   $   #
#  #### #
#       #
#   .   #
#########