#########
#       #
#       #
#  # #  #
#@ #$# .#
#  # #  #
#  # #  #
#       #
#########