#########
#   $  .#
#   $  .#
#   $  .#
#@  $  .#
#   $  .#
#   $  .#
#   $  .#
#########

