#########
#.  $   #
#.  $   #
#.  $   #
#.  $  @#
#.  $   #
#.  $   #
#.  $   #
#########