#########
#   @   #
#       #
#       #
#$$$$$$$#
#       #
#       #
#.......#
#########