#########
#.......#
#       #
#       #
#$$$$$$$#
#       #
#       #
#   @   #
#########